"a" = (/turf/template_noop,/area/space)
"b" = (/obj/structure/shuttle/engine/propulsion{dir = 1; icon_state = "propulsion"},/turf/open/floor/plating/airless,/area/space)
"d" = (/obj/structure/chair/comfy/shuttle,/obj/structure/window/reinforced{dir = 1},/turf/open/floor/monotile/dark,/area/space)
"e" = (/obj/effect/spawner/structure/window/shuttle,/turf/open/floor/plating,/area/space)
"g" = (/obj/machinery/light{dir = 8},/turf/open/floor/monotile,/area/space)
"i" = (/obj/machinery/computer/ship/navigation/public{dir = 1; name = "starmap console"},/turf/open/floor/monotile/dark,/area/space)
"l" = (/obj/structure/closet/emcloset,/obj/machinery/computer/ship/viewscreen,/turf/open/floor/monotile,/area/space)
"o" = (/obj/structure/shuttle/engine/propulsion{dir = 1; icon_state = "propulsion"},/obj/docking_port/mobile/arrivals{dir = 2; height = 14; name = "theship arrivals shuttle"},/turf/open/floor/plating/airless,/area/space)
"p" = (/obj/structure/closet/emcloset,/obj/machinery/computer/lore_terminal,/turf/open/floor/monotile,/area/space)
"t" = (/turf/closed/wall/mineral/titanium,/area/space)
"w" = (/obj/machinery/light{dir = 4},/turf/open/floor/monotile,/area/space)
"y" = (/obj/item/twohanded/required/kirbyplants{icon_state = "plant-24"},/turf/open/floor/monotile/dark,/area/space)
"z" = (/obj/machinery/door/airlock/titanium,/obj/structure/fans/tiny,/turf/open/floor/plating,/area/space)
"B" = (/obj/structure/table,/obj/item/storage/firstaid/regular,/turf/open/floor/monotile/dark,/area/space)
"E" = (/obj/structure/chair/comfy/shuttle,/turf/open/floor/monotile/dark,/area/space)
"H" = (/obj/machinery/status_display/evac/west,/turf/open/floor/monotile,/area/space)
"I" = (/obj/machinery/computer{dir = 1; name = "Shuttle computer"},/turf/open/floor/monotile/dark,/area/space)
"J" = (/turf/open/floor/monotile/dark,/area/space)
"N" = (/obj/machinery/requests_console{department = "Arrival shuttle"; name = "Arrivals Shuttle console"; pixel_y = -30},/turf/open/floor/monotile,/area/space)
"S" = (/obj/structure/extinguisher_cabinet/east,/turf/open/floor/monotile/dark,/area/space)
"T" = (/obj/structure/shuttle/engine/heater{dir = 1; icon_state = "heater"},/obj/structure/window/reinforced,/turf/open/floor/plating/airless,/area/space)
"V" = (/obj/machinery/status_display/ai/east,/turf/open/floor/monotile,/area/space)
"Y" = (/turf/open/floor/monotile,/area/space)

(1,1,1) = {"
atbobta
ttTTTtt
tlBJypt
tHEEEVt
zYYYYYz
tgdddwt
eYYYYYe
eYdddYe
tgYYYwt
zYdddYz
tNYYYYt
ttJEStt
atIiIta
ateeeta
"}
